WWWWWWWWWWWWWWWW
WBOBBBBBBBBBBBBW
WBBBBBBBWWWWWWWW
WBBBBBBBBBBBOBBW
WBWBBBBBBBBBBBBW
WBWBBBBBBBBBBWBW
WBWBBBBBBBBBBWBW
WBWBBBBBBBBBBWBW
WBWBBBBBBBBBBWBW
WECBBBBBBBBBBWBW
WBBPBBBBBBBBBWBW
WWWWWWWWWWWWWWWW