WWWWWWWWWWWWWWWW
WBBBBBBBBBBBBBOW
WBBBBBBBWWWWWWWW
WBBBBBBBBBBBBBBW
WBWBBBBBBBBBBBBW
WBWBBBBBBBBBBWBW
WBWBBBBBBBBBBWBW
WBWBBBBBBBBBBWBW
WBWBBBBBBBBBBWBW
WECBBBBBBBBBBWOW
WBBPBBBBBBBBBWBW
WWWWWWWWWWWWWWWW