WWWWWWWWWWWWWWWW
WBOBBBBBBBBBOBCW
WBWWWWWWWWWWWWWW
WBBBBBCBBBBBOBBW
WBWWWWWBWWWWWWBW
WBBBWBBBBCBWBBBW
WBWBBBWBWWBBBWBW
WBWWWWWBWWWWWWCW
WBWBBBBBCBBBBWBW
WBWWWBWWWWWBWWOW
WEBPBBBBBBBBBCBW
WWWWWWWWWWWWWWWW