WWWWWWWWWWWWW
WOBBBBBBBBBBW
WWWWWBBWWWWWW
WBWWWBBWWWWWW
WBBBBBBBBBBBW
WBWWWWWWWBWWW
WBBBBBBBBBBBW
WECPBBBBBBBBW
WWWWWWWWWWWWW